+--+--+--+--+--+--+--+--+--+--+--+--+--+--+--+--+
|                                               |
+  +  +  +  +  +  +  +  +  +  +  +  +  +  +  +  +
|                                               |
+  +  +  +  +  +  +  +  +  +  +  +  +  +  +  +  +
|                                               |
+  +  +  +  +  +  +  +  +  +  +  +  +  +  +  +  +
|                                               |
+  +  +  +  +  +  +  +  +  +  +  +  +  +  +  +  +
|                                               |
+  +  +  +  +  +  +  +  +  +  +  +  +  +  +  +  +
|                                               |
+  +  +  +  +  +  +  +  +  +  +  +  +  +  +  +  +
|                                               |
+  +  +  +  +  +  +  +  +  +  +  +  +  +  +  +  +
|                                               |
+  +  +  +  +  +  +  +  +  +  +  +  +  +  +  +  +
|                                               |
+  +  +  +  +  +  +  +  +  +  +  +  +  +  +  +  +
|                                               |
+  +  +  +  +  +  +  +  +  +  +  +  +  +  +  +  +
|                                               |
+  +  +  +  +  +  +  +  +  +  +  +  +  +  +  +  +
|                                               |
+  +  +  +  +  +  +  +  +  +  +  +  +  +  +  +  +
|                                               |
+  +  +  +  +  +  +  +  +  +  +  +  +  +  +  +  +
|                                               |
+  +  +  +  +  +  +  +  +  +  +  +  +  +  +  +  +
|                                               |
+  +  +  +  +  +  +  +  +  +  +  +  +  +  +  +  +
|  |                                            |
+--+--+--+--+--+--+--+--+--+--+--+--+--+--+--+--+
0xffff800000008000000080000000800000008000000080000000800000008000000080000000800000008000000080000000800000008000000080000000c000